1,1,1,1,1,1,1,1,1,1,1,1,1,1,1,1,1,1,1,1
1,0,0,0,0,0,0,0,0,6,1,1,4,0,0,0,0,0,0,1
1,0,5,0,0,0,0,0,0,0,1,1,4,0,0,0,0,0,0,1
1,0,0,0,0,0,0,0,0,0,0,0,0,0,0,1,1,0,0,1
1,0,0,0,0,0,0,0,0,0,1,1,0,0,0,1,0,0,0,1
1,1,1,1,1,1,1,1,0,0,1,1,0,0,0,1,2,0,0,1
1,0,0,0,0,0,1,1,0,0,1,1,0,0,0,1,1,1,1,1
1,0,0,1,0,0,1,1,0,0,1,1,0,0,0,0,0,0,0,1
1,0,0,1,0,0,1,1,0,0,1,1,0,3,0,0,0,0,0,1
1,0,0,1,0,0,1,1,0,0,1,1,7,3,0,0,0,0,0,1
1,0,0,1,0,0,0,0,0,0,1,1,1,1,0,0,0,0,0,1
1,0,0,1,0,0,0,0,0,0,1,1,0,0,0,0,0,0,0,1
1,0,0,1,0,0,0,0,0,0,1,1,0,0,0,0,0,0,0,1
1,0,0,1,0,0,0,0,0,0,1,1,0,0,0,0,0,0,0,1
1,0,0,1,0,0,0,0,0,0,1,1,0,0,0,0,0,0,0,1
1,0,0,1,1,1,1,1,1,1,1,1,0,0,0,0,1,1,1,1
1,0,0,1,0,0,0,0,0,0,1,1,0,0,0,0,0,0,0,1
1,0,0,1,0,0,0,0,0,0,1,1,0,0,0,0,0,0,0,1
1,0,0,1,0,0,0,0,0,0,1,1,0,0,0,0,0,0,0,1
1,0,0,1,0,0,1,1,0,0,1,1,1,1,1,0,0,0,0,1
1,0,0,1,0,0,1,1,0,0,1,0,0,0,0,0,0,0,0,1
1,0,0,1,0,0,1,1,0,0,1,0,0,0,0,0,0,0,0,1
1,0,0,1,0,0,1,0,0,0,1,0,0,0,0,0,0,0,0,1
1,0,0,0,0,0,1,0,0,1,1,0,0,0,1,1,1,1,1,1
1,0,0,0,0,0,1,0,0,0,1,0,0,0,0,0,0,0,0,1
1,0,0,0,0,0,1,0,0,0,1,0,0,0,0,0,0,0,0,1
1,0,0,0,0,0,1,1,0,0,1,1,1,1,1,1,1,0,0,1
1,0,0,0,0,0,1,0,0,0,1,0,0,0,0,0,1,0,0,1
1,0,0,0,0,0,1,0,0,1,1,0,0,0,0,0,1,0,0,1
1,3,3,0,0,0,1,0,0,0,0,0,0,1,0,0,0,0,0,1
1,3,3,0,0,0,1,0,0,0,0,0,0,1,0,0,0,0,0,1
1,1,1,1,1,1,1,1,1,1,1,1,1,1,1,1,1,1,1,1